11111111111111111111111
1PC00000C000000000000E1
11111111111111111111111