11111111
00000111
11100010
11101010
11111111
