111111111
1P1000001
101011101
101010001
100C10E11
101000101
111111111