11111111
00000011
11100101
11000101
11111111
