111111111
1P1CCCCC1
1C1C111C1
1C1C1C1C1
1C1CCCE11
1CCC1CC11
111111111