11111111111111111111111
1CC00000000000000000001
10101110000000000100001
1C10101000000C000100001
10100CE100000000010C001
10001C01000000000100001
100010010000C0000100001
10C010010C000000010C001
100010C1000000000100001
100010010P00C0000100001
1000100100000000010C001
100C1001000000000100001
1C0010010000C0000100001
11111111111111111111111