11111111111111111111111
1CC00000000000000000001
10101110000000000100001
1C101010000000000100001
10100CE1000000000100001
10001C01000000000100001
10P01001000000000100001
10C01001000000000100001
10001001000000000100001
10001001000000000100001
10001001000000000100001
10001001000000000100001
10001001000000000100001
11111111111111111111111